"filename", "language", "Vue", "comment", "blank", "total"
"c:\Users\Yemax\Desktop\lession\tournament\src\views\LoginView.vue", "Vue", 295, 4, 40, 339
"c:\Users\Yemax\Desktop\lession\tournament\src\views\admin\AdminView.vue", "Vue", 155, 5, 23, 183
"c:\Users\Yemax\Desktop\lession\tournament\src\views\admin\AuthorizeLeaderView.vue", "Vue", 170, 2, 11, 183
"c:\Users\Yemax\Desktop\lession\tournament\src\views\admin\AuthorizeRefereeView.vue", "Vue", 167, 2, 11, 180
"c:\Users\Yemax\Desktop\lession\tournament\src\views\admin\EventDialogView.vue", "Vue", 172, 10, 23, 205
"c:\Users\Yemax\Desktop\lession\tournament\src\views\admin\EventView.vue", "Vue", 184, 3, 14, 201
"c:\Users\Yemax\Desktop\lession\tournament\src\views\admin\MatchADialogView.vue", "Vue", 255, 4, 27, 286
"c:\Users\Yemax\Desktop\lession\tournament\src\views\admin\MatchAView.vue", "Vue", 239, 4, 14, 257
"c:\Users\Yemax\Desktop\lession\tournament\src\views\admin\MatchBDialogView.vue", "Vue", 361, 8, 31, 400
"c:\Users\Yemax\Desktop\lession\tournament\src\views\admin\MatchBView.vue", "Vue", 226, 4, 13, 243
"c:\Users\Yemax\Desktop\lession\tournament\src\views\admin\MatchModeDialogView.vue", "Vue", 231, 5, 24, 260
"c:\Users\Yemax\Desktop\lession\tournament\src\views\admin\MatchModeView.vue", "Vue", 210, 3, 13, 226
"c:\Users\Yemax\Desktop\lession\tournament\src\views\leader\LeaderRegisterView.vue", "Vue", 166, 1, 15, 182
"c:\Users\Yemax\Desktop\lession\tournament\src\views\leader\LeaderView.vue", "Vue", 155, 7, 23, 185
"c:\Users\Yemax\Desktop\lession\tournament\src\views\leader\MatchADialogView.vue", "Vue", 291, 2, 21, 314
"c:\Users\Yemax\Desktop\lession\tournament\src\views\leader\MatchAView.vue", "Vue", 305, 5, 23, 333
"c:\Users\Yemax\Desktop\lession\tournament\src\views\leader\MatchBDialogView.vue", "Vue", 294, 0, 19, 313
"c:\Users\Yemax\Desktop\lession\tournament\src\views\leader\MatchBView.vue", "Vue", 270, 4, 22, 296
"c:\Users\Yemax\Desktop\lession\tournament\src\views\leader\PlayerDialogView.vue", "Vue", 176, 0, 17, 193
"c:\Users\Yemax\Desktop\lession\tournament\src\views\leader\PlayerView.vue", "Vue", 245, 0, 23, 268
"c:\Users\Yemax\Desktop\lession\tournament\src\views\referee\MatchAScoreView.vue", "Vue", 354, 1, 42, 397
"c:\Users\Yemax\Desktop\lession\tournament\src\views\referee\MatchAView.vue", "Vue", 240, 0, 24, 264
"c:\Users\Yemax\Desktop\lession\tournament\src\views\referee\MatchBScoreView.vue", "Vue", 321, 4, 40, 365
"c:\Users\Yemax\Desktop\lession\tournament\src\views\referee\MatchBView.vue", "Vue", 257, 0, 26, 283
"c:\Users\Yemax\Desktop\lession\tournament\src\views\referee\RefereeRegisterView.vue", "Vue", 135, 2, 5, 142
"c:\Users\Yemax\Desktop\lession\tournament\src\views\referee\RefereeView.vue", "Vue", 148, 7, 22, 177
"c:\Users\Yemax\Desktop\lession\tournament\src\views\visitor\MatchADetailView.vue", "Vue", 401, 4, 48, 453
"c:\Users\Yemax\Desktop\lession\tournament\src\views\visitor\MatchAView.vue", "Vue", 354, 4, 44, 402
"c:\Users\Yemax\Desktop\lession\tournament\src\views\visitor\MatchBDetailView.vue", "Vue", 346, 4, 44, 394
"c:\Users\Yemax\Desktop\lession\tournament\src\views\visitor\MatchBView.vue", "Vue", 351, 4, 44, 399
"c:\Users\Yemax\Desktop\lession\tournament\src\views\visitor\VisitorView.vue", "Vue", 147, 6, 22, 175
"Total", "-", 7621, 109, 768, 8498